13
1111111111111
1000111110001
1011110111101
1011110111101
1111010101101
1111011101111
1000011100001
1111011101111
1111010101111
1011110111101
1011110111101
1000111110001
1111111111111